NO ./textures/wall_1.xpm
SO ./textures/wall_2.xpm
WE ./textures/wall_3.xpm
EA ./textures/wall_4.xpm

F 24, 27, 24
C 255, 255, 255

        1111111111111111111111111                          
        1000000000110000000000001
        1011000001110000000000001
        1001000000000000001000001
111111111011000001110000000000001
10000000001100000011011101C101111
111101111111110111000000O0001
11110111111111011101010010001
11000000110101011100000010001
10000000000000011000000100E01
10000000000000001101010010001
1100000111010101111101111000111
11110111 1110101 101111010001
11111111 1111111 111111111111




                1111111
                1000001
                1010101
                1000001
                1000001
                1010101
                 1 1 1
