NO ./textures/wall_1.xpm
SO ./textures/wall_2.xpm
WE ./textures/wall_3.xpm
EA ./textures/wall_4.xpm

F 220, 0, 1
C 225, 1, 4

        1111111111111111111111111                                                                                
        1000000000110000000000001
        1011000101110000000000001
        1001001 10000000001000001
111111111011000111100000000000001
100000000011000001110111111111111
11110111111111011100000010001   1
11110111111111011101010010001   1
11000000110101011100000010001   1
10000000000000001100000010001   1
10000000000000001101010010001   1
11000001110101011111011110N0111 1
11110111 1110101 101111010001   1
11111111 1111111 111111111111   1
                                1
                                1
                                1
                                1
                                1
                                1
                                1
                                1
                                1
                                1
                                1
111111111111111111111111111111111








