NO ./assets/textures/lyon.xpm
SO ./assets/textures/almond_tree.xpm
WE ./assets/textures/chateau.xpm
EA ./assets/textures/Starry_Night_Over_the_Rhone.xpm

C  0,   0,   255
F  255, 255, 0


111111111111111111111111111111111111
100000000000000000000000000000000001
100000000000000000000000000000110001
10000011000000000S000000000000000001
100000110000000000000000000000000001
100000000000001111110000000000000001
100000000000001    10000000000000001
100000000000001    1CCOOOO1000000001
100000000000001    10000000000000001
100000000000001111110000000000000001
100000000000000000000000000000100001
100100000000000000000000000000000001
100000000000000000000000000000000001
111111111111111111111111111111111111